120000000000021
400000000000004
000000000000000
000000000000000
004242424242400
002111111111200
004111111111400
003333333333300
000000000000000
000000000000000
000000000000000
000000000000000
000000000000000
000000000000000
000000000000000
