120000000000021
200000000000002
002424242424200
001000000000100
001005000500100
002000000000200
001000000000100
002010000010200
001002424200100
002000000000200
001313131313100
000000000000000
000000000000000
000000000000000
000000000000000
