210000000000012
300000000000003
000000000000000
000000000000000
021000000000120
012005000500210
021000000000120
012000030000210
021000121000120
012004202400210
021012000210120
012420000024210
021200000002120
000000000000000
000000000000000
