804343434343408
000000000000000
000000000000000
102132413241201
203040304030402
104102010201301
803040304030408
102102010201201
803040304030408
104102010201301
803040304030408
102102010201201
803040304030408
300000000000003
000000000000000
